prison-map-prison	prison
HMP/YOI Altcourse	AC
HMP Ashfield	AS
HMP/YOI Askham Grange	AG
HMYOI Aylesbury	AY
HMP/YOI Bedford	BF
HMP/YOI Belmarsh	BA
HMP Berwyn	
HMP Birmingham	BM
HMP Blantyre House	BH
HMP/YOI Brinsford	BS
HMP/YOI Bristol	BL
HMP Brixton	BX
HMP/YOI Bronzefield (F)	BZ
HMP Buckley Hall	BC
HMP/YOI Bullingdon	BN
HMP Bure	BR
HMP/YOI Cardiff	CF
HMP Channings Wood	CW
HMP/YOI Chelmsford	CD
HMP Coldingley	CL
HMYOI Cookham Wood	CK
HMP Dartmoor	DA
HMYOI Deerbolt	DT
HMP/YOI Doncaster	DN
HMP Dovegate	DG
HMP/YOI Downview	DW
HMP/YOI Drake Hall	DH
HMP/YOI Durham	DM
HMP/YOI East Sutton Park	ES
HMP/YOI Eastwood Park	EW
HMP/YOI Elmley	EY
HMP Erlestoke	EE
HMP/YOI Exeter	EX
HMP Featherstone	FS
HMYOI Feltham	FM
HMP Ford	FD
HMP/YOI Forest Bank	FB
HMP/YOI Foston Hall	FH
HMP Frankland	FK
HMP Full Sutton	FN
HMP Garth	GH
HMP Gartree	GT
HMP/YOI Glen Parva	GP
HMP Grendon	GN
HMP Guys Marsh	GM
HMP/YOI Hatfield	HD
HMP Haverigg	HV
HMP Hewell	HE
HMP/YOI Highdown	
HMP Highpoint	HP
HMP/YOI Hindley	HI
HMP/YOI Hollesley Bay	HB
HMP/YOI Holme House	HH
HMP/YOI Hull	HL
HMP Humber	HM
HMP Huntercombe (FNP)	HC
HMP/YOI Isis	IS
HMP/YOI Isle of Wight	IW
HMP Kennet	KT
HMP Kirkham	KM
HMP Kirklevington Grange	KV
HMP Lancaster Farms	LF
HMP Leeds	LE
HMP Leicester	LC
HMP/YOI Lewes	LW
HMP Leyhill	LY
HMP/YOI Lincoln	LI
HMP Lindholme	LH
HMP Littlehey	LT
HMP Liverpool	LP
HMP Long Lartin	LL
HMP/YOI Low Newton	LN
HMP Lowdham Grange	LG
HMP Maidstone (FNP)	MS
HMP/YOI Manchester	MR
Medway STC	MW
HMP/YOI Moorland	MD
HMIRC Morton Hall (IRC)	MH
HMP/YOI New Hall	NH
HMP North Sea Camp	NS
HMP Northumberland	NL
HMP/YOI Norwich	NW
HMP/YOI Nottingham	NM
HMP Oakwood	OW
HMP Onley	ON
HMP/YOI Parc (YP)	PR
HMP/YOI Pentonville	PV
HMP/YOI Peterborough (F)	PB
HMP/YOI Portland	PD
HMP/YOI Preston	PN
HMP Ranby	RN
HMP Risley	RS
HMP/YOI Rochester	RC
HMP Rye Hill	RH
HMP/YOI Send	SD
HMP Spring Hill	
HMP Stafford	SF
HMP Standford Hill	EH
HMP Stocken	SK
HMP/YOI Stoke Heath	SH
HMP/YOI Styal	ST
HMP Sudbury	SU
HMP Swaleside	SL
HMP/YOI Swansea	SW
HMP/YOI Swinfen Hall	SN
HMP/YOI Thameside	TS
HMP The Mount	MT
HMIRC The Verne (IRC)	VE
HMP/YOI Thorn Cross	TC
HMP Usk and HMP/YOI Prescoed	
HMP Wakefield	WD
HMP/YOI Wandsworth	WW
HMP/YOI Warren Hill	WI
HMP Wayland	WL
HMP Wealstun	WE
HMYOI Werrington	WN
HMYOI Wetherby	WY
HMP Whatton	WT
HMP Whitemoor	WR
HMP/YOI Winchester	WC
HMP/YOI Woodhill	WH
HMP/YOI Wormwood Scrubs	WS
HMP/YOI Wymott	WM
